Acanthias vulgaris	NE
Aetobatus narinari	NT
Aetomylaeus bovinus	DD
Alopias pelagicus	EN
Alopias superciliosus	VU
Alopias vulpes	NE
Alopias vulpinus	VU
Anoxypristis cuspidata	EN
Carcharhinus acronotus	NT
Carcharhinus albimarginatus	VU
Carcharhinus altimus	DD
Carcharhinus amblyrhynchoides	NT
Carcharhinus amblyrhynchos	NT
Carcharhinus amboinensis	NT
Carcharhinus brachiurus	NE
Carcharhinus brachyurus	VU
Carcharhinus brevipinna	NT
Carcharhinus commersonii	NE
Carcharhinus falciformis	VU
Carcharhinus galapagensis	LC
Carcharhinus gangeticus	NE
Carcharhinus isodon	LC
Carcharhinus lamiella	NE
Carcharhinus leucas	NT
Carcharhinus limbatus	NT
Carcharhinus longimanus	CR
Carcharhinus macloti	NT
Carcharhinus maculipinnis	NE
Carcharhinus melanopterus	NT
Carcharhinus obscurus	EN
Carcharhinus plumbeus	VU
Carcharhinus porosus	DD
Carcharhinus sealei	NT
Carcharhinus signatus	DD
Carcharhinus sorrah	NT
Carcharhinus velox	NE
Carcharias elegans	NE
Carcharias taurus	VU
Carcharias tricuspidatus	NE
Carcharias vorax	NE
Carcharodon arnoldi	NE
Carcharodon carcharias	VU
Carcharodon purplei	NE
Carcharodon riversi	NE
Carcharodon rondeleti	NE
Carcharodon sulcidens	NE
Centrophorus granulosus	DD
Centrophorus radicans	NE
Centrophorus squamosus	VU
Centroscymnus coelolepis	NT
Centroscymnus owstoni	NE
Cephaloscyllium ventriosum	LC
Cestracion longidens	NE
Cestracion zygaena	NE
Cetorhinus maximus	EN
Cheirostephanus hurzeleri	NE
Chlamydoselachus anguineus	LC
Dalatias licha	VU
Dasyatis americana	NE
Dasyatis pastinaca	DD
Deania calcea	LC
Deania calceus	NE
Echinorhinus brucus	DD
Echinorhinus cookei	DD
Etmopterus polli	DD
Etmopterus spinax	LC
Eugomphodus taurus	NE
Galeocerdo arcticus	NE
Galeocerdo cuvier	NT
Galeocerdo cuvieri	NE
Galeolamna gangetica	NE
Galeorhinus australis	NE
Galeorhinus galeus	VU
Galeorhinus zyopterus	NE
Galeus canis	NE
Galeus melastomus	LC
Galeus zyopterus	NE
Ginglymostoma cirratum	NT
Glyphis glyphis	EN
Gymnura altavela	VU
Hemipristis elongatus	NE
Heptranchias perlo	NT
Heterodontus francisci	DD
Heterodontus japonicus	LC
Hexanchus griseus	NT
Hexanchus nakamurai	DD
Hypoprion macloti	NE
Isurus glaucus	NE
Isurus hastalis	NE
Isurus oxyrhinchus	NE
Isurus oxyrhynchus	NE
Isurus oxyrinchus	EN
Isurus paucus	EN
Isurus spallanzani	NE
Isurus spallanzanii	NE
Lamna ditropis	LC
Lamna nasus	VU
Megachasma pelagios	LC
Miroscyllium sheikoi	DD
Mitsukurina owstoni	LC
Mobula hypostoma	EN
Mobula munkiana	VU
Mobula tarapacana	EN
Mobula thurstoni	EN
Mollisquama parini	DD
Mustelus californicus	LC
Mustelus henlei	LC
Mustelus lunulatus	LC
Myliobatis aquila	DD
Myliobatis californica	NE
Myliobatis californicus	LC
Myliobatis freminvillii	DD
Myliobatis tenuicaudatus	LC
Nebrius ferrugineus	VU
Negaprion brevirostris	NT
Negaprion fronto	NE
Notidanus gigas	NE
Notorhynchus cepedianus	NE
Notorynchus cepedianus	DD
Notorynchus maculatum	NE
Notorynchus maculatus	NE
Odontaspis ferox	VU
Odontaspis littoralis	NE
Odontaspis taurus	NE
Odontaspis tricuspidatus	NE
Oxynotus centrina	VU
Oxyrhina spallanzanii	NE
Platyrhinoidis triseriata	LC
Potamotrygon motoro	DD
Prionace glauca	NT
Prionace glaucus	NE
Pristiophorus cirratus	LC
Pristiophorus japonicus	DD
Pristiophorus schroederi	DD
Pristis pectinata	CR
Pristis pectinatus	NE
Pristis perotteti	NE
Pristis pristis	CR
Procarcharodon rondeletti	NE
Pseudocarcharias kamoharai	LC
Pseudoginglymostoma brevicaudatum	CR
Pterolamiops longimanus	NE
Pteromylaeus bovina	NE
Pteromylaeus bovinus	NE
Raja agassizi	NE
Raja agassizii	NE
Raja batis	NE
Raja clavata	NT
Raja montagui	LC
Rhina ancylostoma	CR
Rhincodon typus	EN
Rhiniodon typus	NE
Rhinoptera bonasus	NT
Rhinoptera brasiliensis	EN
Rhinoptera steindachneri	NT
Rhizoprionodon acutus	LC
Rhizoprionodon lalandii	DD
Rhizoprionodon longurio	DD
Rhizoprionodon terraenovae	LC
Rhynchobatus luebberti	CR
Scoliodon laticaudus	NT
Scoliodon longurio	NE
Scoliodon sorrakawah	NE
Scoliodon sorrakowah	NE
Scoliodon terraenovae	NE
Scoliodon terranovae	NE
Scyliorhinus stellaris	NT
Scyllium vincenti	NE
Scymnodalatias garricki	DD
Scymnodon obscurus	NE
Scymnodon ringens	DD
Scymnorhinus licha	NE
Selache aurata	NE
Somniosus microcephalus	NT
Somniosus rostratus	DD
Sphyrna diplana	NE
Sphyrna lewini	CR
Sphyrna media	DD
Sphyrna mokarran	CR
Sphyrna tiburo	LC
Sphyrna vespertina	NE
Sphyrna zigaena	NE
Sphyrna zygaena	VU
Squalus acanthias	VU
Squalus appendiculatus	NE
Squalus blainvillei	NE
Squalus cubensis	DD
Squalus megalops	DD
Squalus suckleyi	LC
Squatina africana	NT
Squatina californica	NT
Squatina dumeril	LC
Squatina japonica	VU
Squatina squatina	CR
Triaenodon obesus	NT
Triakis semifasciata	LC
Urobatis halleri	LC
Urolophus cruciatus	LC
Urolophus halleri	NE
Zameus squamulosus	DD
